01110011111100000000000000000000000000000000000000
01110011111100000000000000000000000000000000000000
11111111111100000000000000000000000000000000000000
11110011111100000000000000000000000000000000000000
11110011111100000000000000000000000000000000000000
11111100010000000000000000000000000000000000000000
11111101111000000000000000000000000000000000000000
11111101111000000000000000000000000000000000000000
11111111111111100000000000000000000000000000000000
11111111111111111000000000000000000000000000000000
11111111111111111000000000000000000000000000000000
11111110011111111100000000000000000000000000000000
11111110001111111100000000000000000000000000000000
11111100001111111100000000000000000000000000000000
11111100000000000100000000000000000000000000000000
00111100000000000100000000000000000000000000000000
11111000000000000100000000000000000000000000000000
11000000000000000100001111000000000000000000000000
11000000000000000100111111000000000000000000000000
11000000000000111111111111000000000000000000000000
11100000000000111111111111110000000000000000000000
11100000000000111111111111010000000000000000000000
11100000000000000000111111010000000000000000000000
10000001110000000000010001111110000000000000000000
10000001110000000000010111111110000000000000000000
11111001110000000000011111111111110000000000000000
11111111110000000000000111111111110000000000000000
11111001110000000000000111111111111100000000000000
00000001110000000000011111111111111100000000000000
00000000010000000001111111111111111100000000000000
00000000111000011111111111111111111100000000000000
00000001111100000001111111111111111100000000000000
00000001111100000000011111111110010000000000000000
00000001111100000000000111111111110000000000000000
00000001111100000000000000111111000000000000000000
00000001111100000000000000111111000000000000000000
00000000111100000000000000111111000000000000000000
00000001111100000111111111111111000000000000000000
00000001111100000111111111101110000000000000000000
00000011111111111111111111111110000000000000000000
00000001111100000111111111101110000000000000000000
00000000111100000111111000001110000000000000000000
00000000000000000000000000000000000000000000000000
00000000000000000000000000000000000000000000000000
00000000000000000000000000000000000000000000000000
00000000000000000000000000000000000000000000000000
00000000000000000000000000000000000000000000000000
00000000000000000000000000000000000000000000000000
00000000000000000000000000000000000000000000000000
00000000000000000000000000000000000000000000000000
